BBBBBBBBBBBBBBBBBBBBBBBBB
B                       B
B                       B
B                       B
B                       B
B                       B
B                       B
B                       B
B           S           B
B                       B
BBB                 f   B
BBBBBBBBBBBBBBBBBBBBBBBBB
B                       B
B                       B
B                       B
B                       B
B                       B
B                       B
BBBBBBBBBBBBBBBBBBBBBBBBB