BBBBBBBBBBBBBBBBBBBBBBBBB 
BBBBBBBBBBBBBBBBBBBBBBBBB
BBBBBBBBBBBBBBBBBBBBBBBBB
BBBBBBBBBBBBBBBBBBBBBBBBB
BBBBBBBBBBBBBBBBBBBBBBBBB
BBBBBBBBBBFFF  BBBBBBBBBB
BBBBB              | BBBB
BBBBF               --BBB
BBBB                 BBBB
BBB         S         BBB
BBB               f    BB
BBB       BBBBBBBBBBB   G
BBB                     G
BBBBPPPPPPPPPPPPPPPPPPBBB
BBBBBBBBBBBBBBBBBBBBBBBBB
BBBBBBBBBBBBBBBBBBBBBBBBB
BBBBBBBBBBBBBBBBBBBBBBBBB
BBBBBBBBBBBBBBBBBBBBBBBBB
BBBBBBBBBBBBBBBBBBBBBBBBB
BBBBBBBBBBBBBBBBBBBBBBBBB