BBBBBBBBBBBBBBBBBBBBBBBBB
B                       B
B                       B
B                       B
B                       B
B                       B
B                       B
BBBB                 BBBB
BBB         S         BBB
B                  X    B
BBB     p               G
BBBBBBBBBBBBBBBBBBBB BBBG
B                       B
B                       B
B                       B
B                       B
B                       B
B                       B
BBBBBBBBBBBBBBBBBBBBBBBBB