BBBBBBBBBBBBBBBBBBBBBBBBB
B                       B
B                       B
B                       B
B                       B
B                       B
B  T                    B
B                       B
B           S           B
B                       B
BBB     p           X   G
BBBBBBBBBBBBBBBBBBBBBBBBG
B                       B
B                       B
B                       B
B                       B
B                       B
B                       B
BBBBBBBBBBBBBBBBBBBBBBBBB