BBBBBBBBBBBBBBBBBBBBBBBBB
B                       B
B                       B
B                       B
B                       B
B                       B
B                       B
B                       B
B                       B
B                       B
B                       B
B                       B
B                       B
B                       B
B                       B
B           BBB         B
B                       B
B   BBBBB               B
B                       B
BBBBBBBBBBBBBBBBBBBBBBBBB