BBBBBBBBBBBBBBBBBBBBBBBBB
B                       B
B                       B
B                       B
B                       B
B                       B
B                       B
B                       B
B           S           B
B                       B
BBB                 X   G
BBBBBBBBBBBBBBBBBBBBBBBBG
B                       B
B                       B
B                       B
B                       B
B                       B
B                       B
BBBBBBBBBBBBBBBBBBBBBBBBB